60	60																																																										
6	6	6	6	6	6	6	6	6	6	6	6	6	6	6	6	6	6	6	6	6	6	6	6	6	6	6	6	6	6	6	6	6	6	6	6	6	6	6	6	6	6	6	6	6	6	6	6	6	6	6	6	6	6	6	6	6	6	6	6
6	0	0	0	0	0	0	0	0	0	0	0	0	0	0	0	0	0	0	0	0	0	0	0	0	0	0	0	0	0	0	0	0	0	0	0	0	0	0	0	0	0	0	0	0	0	0	0	0	0	0	0	0	0	0	0	0	0	0	6
6	0	0	0	0	0	0	0	0	0	0	0	0	0	0	0	0	0	0	0	0	0	0	0	0	0	0	0	0	0	0	0	0	0	0	0	0	0	0	0	0	0	0	0	0	0	0	0	0	0	0	0	0	0	0	0	0	0	0	6
6	0	0	0	0	0	0	0	0	0	0	0	0	0	0	0	0	0	0	0	0	0	0	0	0	0	0	0	0	0	0	0	0	0	0	0	0	0	0	0	0	0	0	0	0	0	0	0	0	0	0	0	0	0	0	0	0	0	0	6
6	0	0	0	0	0	0	0	0	0	0	0	0	0	0	0	0	0	0	0	0	0	0	0	0	0	0	0	0	0	0	0	0	0	0	0	0	0	0	0	0	0	0	0	0	0	0	0	0	0	0	0	0	0	0	0	0	0	0	6
6	0	0	0	0	0	0	0	0	0	0	0	0	0	0	0	0	0	0	0	0	0	0	0	0	0	0	0	0	0	0	0	0	0	0	0	0	0	0	0	0	0	0	0	0	0	0	0	0	0	0	0	0	0	0	0	0	0	0	6
6	0	0	0	0	0	0	0	0	0	0	0	0	0	0	0	0	0	0	0	0	0	0	0	0	0	0	0	0	0	0	0	0	0	0	0	0	0	0	0	0	0	0	0	0	0	0	0	0	0	0	0	0	0	0	0	0	0	0	6
6	0	6	0	6	0	6	0	6	0	6	0	0	0	0	0	0	0	0	0	0	0	0	0	0	0	0	0	0	0	0	0	0	0	0	0	0	0	0	0	0	0	0	0	0	0	0	0	6	0	6	0	6	0	6	0	6	0	0	6
6	0	0	6	0	6	0	6	0	6	0	6	0	0	0	0	0	0	0	0	0	0	0	0	0	0	0	0	0	0	0	0	0	0	0	0	0	0	0	0	0	0	0	0	0	0	0	0	0	6	0	6	0	6	0	6	0	6	0	6
6	0	0	0	0	0	0	0	0	0	0	0	0	0	0	0	0	0	0	0	0	0	0	0	0	0	0	0	0	0	0	0	0	0	0	0	0	0	0	0	0	0	0	0	0	0	0	0	0	0	0	0	0	0	0	0	0	0	0	6
6	0	0	0	0	0	0	0	0	0	0	0	0	0	0	0	0	0	0	0	0	0	0	0	0	0	0	0	0	0	0	0	0	0	0	0	0	0	0	0	0	0	0	0	0	0	0	0	0	0	0	0	0	0	0	0	0	0	0	6
6	0	0	0	0	0	0	0	0	0	0	0	0	0	0	0	0	0	0	0	0	0	0	0	0	0	0	0	0	0	0	0	0	0	0	0	0	0	0	0	0	0	0	0	0	0	0	0	0	0	0	0	0	0	0	0	0	0	0	6
6	0	0	0	0	0	0	0	0	0	0	0	0	0	6	6	6	6	0	0	6	6	6	6	0	0	6	6	5	5	5	5	5	6	6	0	0	6	6	5	5	5	5	5	6	6	0	0	0	0	0	0	0	0	0	0	0	0	0	6
6	0	0	0	0	0	0	0	0	0	0	0	0	0	6	0	6	6	0	0	6	6	0	6	0	0	6	1	1	1	1	1	1	1	6	0	0	6	1	1	1	1	1	1	1	6	0	0	0	0	0	0	0	0	0	0	0	0	0	6
6	0	0	0	0	0	0	0	0	0	0	0	0	0	6	0	6	6	6	6	6	6	0	6	0	0	6	1	1	1	1	1	1	1	6	0	0	6	1	1	1	1	1	1	1	6	0	0	0	0	0	0	0	0	0	0	0	0	0	6
6	0	0	0	0	0	0	0	0	0	0	0	0	0	6	2	0	6	6	6	6	0	2	6	0	0	6	1	1	1	1	1	1	1	6	0	0	6	1	1	1	1	1	1	1	6	0	0	0	0	0	0	0	0	0	0	0	0	0	6
6	0	0	0	0	0	0	0	0	0	0	0	0	0	6	0	0	6	6	6	6	0	0	6	0	0	6	1	1	1	1	1	1	1	6	0	0	6	1	1	1	1	1	1	1	6	0	0	0	0	0	0	0	0	0	0	0	0	0	6
6	0	0	0	0	0	0	0	0	0	0	0	0	0	6	0	0	6	6	6	6	0	0	6	0	0	6	1	1	1	1	1	1	1	6	0	0	6	1	1	1	1	1	1	1	6	0	0	0	0	0	0	0	0	0	0	0	0	0	6
6	0	0	0	0	0	0	0	0	0	0	0	0	0	6	0	0	6	6	6	6	0	0	6	0	0	6	1	1	1	1	1	1	1	6	0	0	6	1	1	1	1	1	1	1	6	0	0	0	0	0	0	0	0	0	0	0	0	0	6
6	0	0	0	0	0	0	0	0	0	0	0	0	0	6	0	0	6	6	6	6	0	0	6	0	0	6	1	1	1	1	1	1	1	6	0	0	6	1	1	1	1	1	1	1	6	0	0	0	0	0	0	0	0	0	0	0	0	0	6
6	0	0	0	0	0	0	0	0	0	0	0	0	0	6	0	0	6	6	6	6	0	0	6	0	0	6	1	1	1	1	1	1	1	6	0	0	6	1	1	1	1	1	1	1	6	0	0	0	0	0	0	0	0	0	0	0	0	0	6
6	0	0	0	0	0	0	0	0	0	0	0	0	0	6	0	0	6	6	6	6	0	0	6	0	0	6	1	1	1	1	1	1	1	6	0	0	6	1	1	1	1	1	1	1	6	0	0	0	0	0	0	0	0	0	0	0	0	0	6
6	0	0	0	0	0	0	0	0	0	0	0	0	0	6	0	0	6	6	6	6	0	0	6	0	0	6	1	1	1	1	1	1	1	6	0	0	6	1	1	1	1	1	1	1	6	0	0	0	0	0	0	0	0	0	0	0	0	0	6
6	0	0	0	0	0	0	0	0	0	0	0	0	0	6	0	0	6	2	2	6	0	0	6	0	0	6	1	1	1	1	1	1	1	6	0	0	6	1	1	1	1	1	1	1	6	0	0	0	0	0	0	0	0	0	0	0	0	0	6
6	0	0	0	0	0	0	0	0	0	0	0	0	0	6	0	0	6	1	1	6	0	0	6	0	0	6	1	1	1	1	1	1	1	6	0	0	6	1	1	1	1	1	1	1	6	0	0	0	0	0	0	0	0	0	0	0	0	0	6
6	6	6	6	6	6	0	0	0	0	0	0	0	0	6	0	0	6	1	1	6	0	0	6	0	0	6	1	1	1	1	1	1	1	6	0	0	6	1	1	1	1	1	1	1	6	0	0	0	0	0	0	0	0	6	6	6	6	6	6
6	1	1	1	1	5	0	0	0	0	0	0	0	0	6	0	0	6	1	1	6	0	0	6	0	0	6	1	1	1	1	1	1	1	6	0	0	6	1	1	1	1	1	1	1	6	0	0	0	0	0	0	0	0	5	1	1	1	1	6
6	1	1	1	1	5	0	0	0	0	0	0	0	0	6	0	0	6	1	1	6	0	0	6	0	0	6	1	1	1	1	1	1	1	6	0	0	6	1	1	1	1	1	1	1	6	0	0	0	0	0	0	0	0	5	1	1	1	1	6
6	1	1	1	1	5	0	0	0	0	0	0	0	0	6	0	0	6	5	5	6	0	0	6	0	0	6	1	1	1	1	1	1	1	6	0	0	6	1	1	1	1	1	1	1	6	0	0	0	0	0	0	0	0	5	1	1	1	1	6
6	1	1	1	1	5	0	0	0	0	0	0	0	0	6	0	0	0	0	0	0	0	0	6	0	0	6	1	1	1	1	1	1	1	6	0	0	6	1	1	1	1	1	1	1	6	0	0	0	0	0	0	0	0	5	1	1	1	1	6
6	1	1	1	1	5	0	0	0	0	0	0	0	0	6	0	0	0	0	0	0	0	0	6	0	0	6	1	4	4	4	4	4	1	6	0	0	6	1	3	3	3	3	3	1	6	0	0	0	0	0	0	0	0	5	1	1	1	1	6
6	1	1	1	1	5	0	0	0	0	0	0	0	0	6	0	0	0	0	0	0	0	0	6	0	0	6	1	1	1	1	1	1	1	6	0	0	6	1	1	1	1	1	1	1	6	0	0	0	0	0	0	0	0	5	1	1	1	1	6
6	1	1	1	1	5	0	0	0	0	0	0	0	0	6	0	0	0	0	0	0	0	0	6	0	0	6	1	1	1	1	1	1	1	6	0	0	6	1	1	1	1	1	1	1	6	0	0	0	0	0	0	0	0	5	1	1	1	1	6
6	6	6	6	6	6	0	0	0	0	0	0	0	0	6	0	0	0	0	0	0	0	0	6	0	0	6	1	1	1	1	1	1	1	6	0	0	6	1	1	1	1	1	1	1	6	0	0	0	0	0	0	0	0	6	6	6	6	6	6
6	0	0	0	0	0	0	0	0	0	0	0	0	0	6	0	0	0	0	0	0	0	0	6	0	0	6	1	1	1	1	1	1	1	6	0	0	6	1	1	1	1	1	1	1	6	0	0	0	0	0	0	0	0	0	0	0	0	0	6
6	0	0	0	0	0	0	0	0	0	0	0	0	0	6	0	0	0	0	0	0	0	0	6	0	0	6	1	1	1	1	1	1	1	6	0	0	6	1	1	1	1	1	1	1	6	0	0	0	0	0	0	0	0	0	0	0	0	0	6
6	0	0	0	0	0	0	0	0	0	0	0	0	0	6	0	0	0	0	0	0	0	0	6	0	0	6	1	1	1	1	1	1	1	6	0	0	6	1	1	1	1	1	1	1	6	0	0	0	0	0	0	0	0	0	0	0	0	0	6
6	0	0	0	0	0	0	0	0	0	0	0	0	0	5	0	0	0	0	0	0	0	0	6	0	0	6	1	1	1	1	1	1	1	6	0	0	6	1	1	1	1	1	1	1	6	0	0	0	0	0	0	0	0	0	0	0	0	0	6
6	0	0	0	0	0	0	0	0	0	0	0	0	0	5	0	0	0	0	0	0	0	0	6	0	0	6	1	1	1	1	1	1	1	6	0	0	6	1	1	1	1	1	1	1	6	0	0	0	0	0	0	0	0	0	0	0	0	0	6
6	0	0	0	0	0	0	0	0	0	0	0	0	0	5	0	0	0	0	0	0	0	0	6	0	0	6	1	1	1	1	1	1	1	6	0	0	6	1	1	1	1	1	1	1	6	0	0	0	0	0	0	0	0	0	0	0	0	0	6
6	0	0	0	0	0	0	0	0	0	0	0	0	0	5	0	0	0	0	0	0	0	0	6	0	0	6	1	1	1	1	1	1	1	6	0	0	6	1	1	1	1	1	1	1	6	0	0	0	0	0	0	0	0	0	0	0	0	0	6
6	0	0	0	0	0	0	0	0	0	0	0	0	0	5	0	0	0	0	0	0	0	0	6	0	0	6	1	1	1	1	1	1	1	6	0	0	6	1	1	1	1	1	1	1	6	0	0	0	0	0	0	0	0	0	0	0	0	0	6
6	0	0	0	0	0	0	0	0	0	0	0	0	0	6	0	0	0	0	0	0	0	0	6	0	0	6	1	1	1	1	1	1	1	6	0	0	6	1	1	1	1	1	1	1	6	0	0	0	0	0	0	0	0	0	0	0	0	0	6
6	0	0	0	0	0	0	0	0	0	0	0	0	0	6	0	0	0	0	0	0	0	0	6	0	0	6	1	1	1	1	1	1	1	6	0	0	6	1	1	1	1	1	1	1	6	0	0	0	0	0	0	0	0	0	0	0	0	0	6
6	0	0	0	0	0	0	0	0	0	0	0	0	0	6	0	0	0	0	0	0	0	0	6	0	0	6	1	1	1	1	1	1	1	6	0	0	6	1	1	1	1	1	1	1	6	0	0	0	0	0	0	0	0	0	0	0	0	0	6
6	0	0	0	0	0	0	0	0	0	0	0	0	0	6	0	0	0	0	0	0	0	0	6	0	0	6	1	1	1	1	1	1	1	6	0	0	6	1	1	1	1	1	1	1	6	0	0	0	0	0	0	0	0	0	0	0	0	0	6
6	0	0	0	0	0	0	0	0	0	0	0	0	0	6	0	0	0	0	0	0	0	0	6	0	0	6	1	1	1	1	1	1	1	6	0	0	6	1	1	1	1	1	1	1	6	0	0	0	0	0	0	0	0	0	0	0	0	0	6
6	0	0	0	0	0	0	0	0	0	0	0	0	0	6	0	0	0	0	0	0	0	0	6	0	0	6	1	1	1	1	1	1	1	6	0	0	6	1	1	1	1	1	1	1	6	0	0	0	0	0	0	0	0	0	0	0	0	0	6
6	0	0	0	0	0	0	0	0	0	0	0	0	0	6	0	0	0	0	0	0	0	0	6	0	0	6	6	5	5	5	5	5	6	6	0	0	6	6	5	5	5	5	5	6	6	0	0	0	0	0	0	0	0	0	0	0	0	0	6
6	0	0	0	0	0	0	0	0	0	0	0	0	0	0	0	0	0	0	0	0	0	0	0	0	0	0	0	0	0	0	0	0	0	0	0	0	0	0	0	0	0	0	0	0	0	0	0	0	0	0	0	0	0	0	0	0	0	0	6
6	0	0	0	0	0	0	0	0	0	0	0	0	0	0	0	0	0	0	0	0	0	0	0	0	0	0	0	0	0	0	0	0	0	0	0	0	0	0	0	0	0	0	0	0	0	0	0	0	0	0	0	0	0	0	0	0	0	0	6
6	0	0	0	0	0	0	0	0	0	0	0	0	0	0	0	0	0	0	0	0	0	0	0	0	0	0	0	0	0	0	0	0	0	0	0	0	0	0	0	0	0	0	0	0	0	0	0	0	0	0	0	0	0	0	0	0	0	0	6
6	0	6	0	6	0	6	0	6	0	6	0	0	0	0	0	0	0	0	0	0	0	0	0	0	0	0	0	0	0	0	0	0	0	0	0	0	0	0	0	0	0	0	0	0	0	0	0	6	0	6	0	6	0	6	0	6	0	0	6
6	0	0	6	0	6	0	6	0	6	0	6	0	0	0	0	0	0	0	0	0	0	0	0	0	0	0	0	0	0	0	0	0	0	0	0	0	0	0	0	0	0	0	0	0	0	0	0	0	6	0	6	0	6	0	6	0	6	0	6
6	0	0	0	0	0	0	0	0	0	0	0	0	0	0	0	0	0	0	0	0	0	0	0	0	0	0	0	0	0	0	0	0	0	0	0	0	0	0	0	0	0	0	0	0	0	0	0	0	0	0	0	0	0	0	0	0	0	0	6
6	0	0	0	0	0	0	0	0	0	0	0	0	0	0	0	0	0	0	0	0	0	0	0	0	0	0	0	0	0	0	0	0	0	0	0	0	0	0	0	0	0	0	0	0	0	0	0	0	0	0	0	0	0	0	0	0	0	0	6
6	0	0	0	0	0	0	0	0	0	0	0	0	0	0	0	0	0	0	0	0	0	0	0	0	0	0	0	0	0	0	0	0	0	0	0	0	0	0	0	0	0	0	0	0	0	0	0	0	0	0	0	0	0	0	0	0	0	0	6
6	0	0	0	0	0	0	0	0	0	0	0	0	0	0	0	0	0	0	0	0	0	0	0	0	0	0	0	0	0	0	0	0	0	0	0	0	0	0	0	0	0	0	0	0	0	0	0	0	0	0	0	0	0	0	0	0	0	0	6
6	0	0	0	0	0	0	0	0	0	0	0	0	0	0	0	0	0	0	0	0	0	0	0	0	0	0	0	0	0	0	0	0	0	0	0	0	0	0	0	0	0	0	0	0	0	0	0	0	0	0	0	0	0	0	0	0	0	0	6
6	6	6	6	6	6	6	6	6	6	6	6	6	6	6	6	6	6	6	6	6	6	6	6	6	6	6	6	6	6	6	6	6	6	6	6	6	6	6	6	6	6	6	6	6	6	6	6	6	6	6	6	6	6	6	6	6	6	6	6
